1111111111
11P1111111
1100011111
1101111111
10000000C1
1000000001
1000000001
1000000001
1C000000E1
1111111111
