111111111
10P000001
000000001
100000000
1000000C1
100000000
0E0000001
100000001
110111111
