111111111
10P000001
100000001
100000001
1000000C1
100000001
1E0000P01
100000001
111111111
