111111111
10P000001
100000001
100000001
1000000C1
1000!0001
1E0000001
100000001
111111111
