111111111
10P000001
100000001
100000F01
1000000C1
100000001
1E000Z001
100000001
111111111
