11111111
0P000001
00000001
00000001
000000C1
00000001
E0000001
00000001
11111111
