11111111
10P00000
10000000
10000000
1000000C
10000000
1E000000
10000000
11111111
