1111111111
10000000C1
10000000000001
10000000000001
1C000000E1
1111111111
