111111111111
1E0000000001
100000000001
100000000001
100000000001
100000000001
100000000001
100100000C01
111011111111
100000000001
1000000000P1
111111111111
