111111111111
1E0000000001
100000000001
100000000001
100000000001
100000000001
100000001111
100100001CC1
100000001001
100000001111
1000000000P1
111111111111
