111111111111
1E0000100001
100000100001
100000100001
100000100001
100000100001
100000100001
100100100C01
100000111111
100000100001
1000001000P1
111111111111
