1111111111
11P1111111
1100011111
1101111111
1000000001
1000000001
1000000001
100000E001
10000000C1
1111111111
