111111111111111111111
100011000011010000011
10000100000000000C0E1
100100001000010101001
100000000000001010111
100110000001100100101
100011000000000000001
100100100000000000001
100011100001010000001
101000010100000001101
110000000100100000P01
100000010111010000101
101111000000011000001
111111111111111111111
