111111111111111
1P0000000000001
101111011111101
100000010000001
101110010111101
100010010000001
101010011110101
100010000000001
101111111110101
100000000000001
101111111110101
100000000000001
101111111110101
1000000C00000E1
101111111111101
111111111111111
