111111111111111111
110001000000000001
101000000000000011
101110111100000001
10000110000100P001
11000000010100C011
100100110100E01001
110100011000101001
100000001000111001
110000100010010101
101000000000110001
111111111111111111
