1111111111111111
1000000000P01001
1010010011000011
1000000000100001
1100001110000011
1000001001100001
1000001000010001
100001100C000101
1100000011000001
1001000000001001
1000000000000001
1000011001001001
1000100000011001
1001100000100011
1100001100100101
1111111111111111
