111111111
10P0000C1
100000001
100000E01
111111111
