111111111
10P0000C1
100011111
100010EC1
111111111
