111111111
10P000001
101111111
1C1000E01
111111111
