111111111
10P000E01
101111111
1C1000E01
111111111
