111111111
10P000001
100111111
1 0111111
1000001C1
100111101
1E0000001
1001111C1
111111111
